NO ./textures/path_to_the_north_texture.xpm
SO ./textures/path_to_the_south_texture.xpm
WE ./textures/path_to_the_west_texture.xpm
EA ./textures/path_to_the_east_texture.xpm

F 220,100,0
C 225,11,12

111111111111111
111000000011111
1011100010001111
1010110000000111
1000000N1111111
111111111111111
