1111111111111
1110000000001
1000000100001
1000000110001
1000000010011
1000011000001
1000011000001
1000011000001
1000011000001
1111111111111










