NO ./pictures/bluestone.xpm
SO ./pictures/eagle.xpm
WE ./pictures/greystone.xpm
EA ./pictures/redbrick.xpm

F 198,140,10
C 111,154,20

        1111111111111111111111111
        10000000001100000000000011111
        10110000011100000N0000001
        1001000000000000000000001
111111111011000001110000000000001
100000000011000001110111111111111
11110111111111111100000010001
11110111111111110000100010011
10000001101010111100000000011
10000000000000000100000010001
10000000000001000101010010001
11000001110101011111011010001
11110111 1110111 100000010001
11111111 1111111 111111111111
