NO ./pictures/square.xpm
SO ./pictures/square.xpm
WE ./pictures/square.xpm
EA ./pictures/square.xpm

F 100,0,139
C 0,0,0

111111111111111111
101000000100000011
101000000000000001
1000N0000010000001
111111111111111111
